10.ox
.o........
.......o.o
.....oo..o
.ooooo.o..
..o..o....
o.....o...
...o......
o...o.....
..........
..........
