10532
5355555555
5555555353
5555533553
5333335355
5535535555
3555553555
5553555555
3555355555
5555555555
5555555555
